8888888888888888888888888888888888888888888888888888888888888888888888888888888888
8777777777777777777777777777777777777777777777777777777777777777777777777777777778
8777777777777777777777777777777777777777777777777777777777777777777777777777777778
8777777777777777777777777777777777777777777777777777777777777777777777777777777778
8777777777777777777777777777777777777777777777777777777777777777777777777777777778
8777777777777777777777777777777777777777777777777777777777777777777777777777777778
877777777@7777777777777777777777777777777777777777777777777777777777777777@7777778
8777777777777777777777777777777777777777777777777777777777777777777777777777777778
8777777777777777777777777777777777777777777777777777777777777777777777777777777778
8777777777777777777777777777777777777777777777777777777777777777777777777777777778
8777777777777777777777777777777777777777777777777777777777777777777777777777777778
8777777777777777777777777777777777777777777777777777777777777777777777777777777778
8777777777777777777777777777777777777777777777777777777777777777777777777777777778
8777777777777777777777777777777777777777777777777777777777777777777777777777777778
8777777777777777777777777777777777777777777777777777777777777777777777777777777778
8777777777777777777777777777777777777777777777777777777777777777777777777777777778
8777777777777777777777777777777777777777777777777777777777777777777777777777777778
8777777777777777777777777777777777777777777777777777777777777777777777777777777778
8777777777777777777777777777777777777777777777777777777777777777777777777777777778
8777777777777777777777777777777777777777777777777777777777777777777777777777777778
8777777777777777777777777777777777777777777777777777777777777777777777777777777778
8777777777777777777777777777777777777777777777777777777777777777777777777777777778
8777777777777777777777777777777777777777777777777777777777777777777777777777777778
8777777777777777777777777777777777777777777777777777777777777777777777777777777778
8777777777777777777777777777777777777777777777777777777777777777777777777777777778
8777777777777777777777777777777777777777777777777777777777777777777777777777777778
8777777777777777777777777777777777777777777777777777777777777777777777777777777778
8777777777777777777777777777777777777777777777777777777777777777777777777777777778
8777777777@7777777777777777777777777777777777777777777777777777777777777777@777778
8777777777777777777777777777777777777777777777777777777777777777777777777777777778
8777777777777777777777777777777777777777777777777777777777777777777777777777777778
8777777777777777777777777777777777777777777777777777777777777777777777777777777778
8777777777777777777777777777777777777777777777777777777777777777777777777777777778
8777777777777777777777777777777777777777777777777777777777777777777777777777777778
8888888888888888888888888888888888888888888888888888888888888888888888888888888888