###################################### ###########################################
#                                    #                                           #
# #############  ##################### ######################################### #
# #                                    # #       ##################            # #
# ######################## ########### # # ### #                    ############ #
# #                      # #         # # ##### ############## ################## #
# ##### ################## # ######### #                #####                    #
# #     # #                #           # ############ #       ################## #
# ##### # # ################### ###### # # #   #   ## #########            #   # #
#       # # #                   #      # # # # # #            # ########## #     #
# ## ####     ############ ######        #   #   ############ #          #     # #
# #  #  # # # ##           # #  ############################# ######## ######### #
# # ##  # # #    ######### # #  #                           # #         ##     # #
### #  #### #### #   ###   # #  # ###### ##################   # ######         # #
#   #     #   ##   #  ## # # #  # ## ### #   ##           #####    ########### # #
# ###   #   #    # ##    # #    # ##     #        ######      # #   #   #    # # #
# #   ##### # ## ######### # #    ##   # #    ##    #### ###  #   #   #   #      #
#   ####  # ##   #    ##   # ######### # #######  #   ##   #    ##################
# #       #    #   ##      # #  #      #          #      #   #     ## ###        #
# ##### ###### ############# #  #   #### ################    #  ##  #     ###### #
#            #               #  ###    #   ########     #    #   #    ###    ### #
## ############# #############    #                 ###      # #    #     ##  ## #
#  #   #    #  # #      #    #    #    ### ################################# #####
# ####   ####    #  #####           #                                            #
# #    #       # #   #  ## ####### ################################# ## ##########
# # ####  ###### #                    #  #       #####       #   ### ## #        #
# #    #  #      ##### ## #####   #   #    ##### #     #####   #     ##  #  #### #
# # #     ### #### #          #   #      # #     #  # #### #   # ### ###  # #  # #
# #    #   #       #    #   ###          # #  #     #      #  #####  # ##      # #
#    ###      # #    #### ###    #   #######  ##############   ####  #  #  # ### #
# ############# #### #  #     # ####                         #    #   #    # # # #
#                    #      ##   #   ############   ######## ###      # #  #   # #
### ################ #  ###  #   #   #              ##     #   ######## ######## #
#              #     #  #      #   #        ####           # #                   #
############################################################ #####################