++++++++111111111+++++++++++++++++333333333+++++++++++++++++444444444+++++++++++++
+       (Level 1)                 (Level 3)                 (Level 4)            +    
+                                                                                +
+                                                                                +
+                                                                                +
+                                                                                +
+                                                                                +
+                                                                                +
+                                                                                +
+                                                                                +
+                                                                                +
+                                                                                +
+                                                                                +
+                                                                                +
+                                                                                +
+                                                                                +
+                                                                                +
+                                                                                +
+                                                                                +
+                                                                                +
+                                                                                +
+                                                                                +
+                                                                                +
+                                                                                +
+                                                                                +
+                                                                                +
+                                                                                +
+                                                                                +
+                                                                                +
+                                                                                +
+                                                                                +
+                                                                                +
+                                                                                +
+                                (Boss level)                                    +
+++++++++++++++++++++++++++++++++000000000000+++++++++++++++++++++++++++++++++++++