88888888888888888888888888888888888888 8888888888888888888888888888888888888888888
8 8   8   8   8   8   8   8   8   8       8   8   8   8   8   8   8   8   8   8  8
8   8   8   8   8   8   8 8 8   888 8   8 8 8   8   8   8   8   8   8 8 8   8   88
8 8 888   8   8   88888   8   8   8   8   8   8   8   8   8   8   8   8   8   8  8
8   8   8   8   8   8 8 8   8   8   8   8   8   8   88888   8   8 8 8   8   8   88
8 8   8   888 8   8   8   8   88888   8   8   8   8   8   8   8   8   8 888   8  8
8   8   8   8   88888   8   8   8   8   88888   8   8   8   8   8 8 8   8   8   88
8 8   8  88   8   8 8 888 8   8   8 888   88888   8   8   8   8   8   8   8   8  8
8   8   8   8   8   8   8 888   8   8   8   8   8   8 8 8   8   8   8   8   8   88
8 8   8   8   8   8   8   8   8   8   8   8   8   8   8   8   8   8   8 888   8  8
8   8   8   88888   8   888 8   8   88888   8   8 8 8   8 888   8   8   8   8   88
8 8   8   8   8   8   8   8   8 8 8   8   8   8   8   8   8 8 8   8   8   8   8  8
8   8888    8   8   8   8   8   88  8  88   8   8   8   8   8   8   8   8   8   88
8 8   8   8   8   8   8   8   8 8 8   8   8   8   888 8   8 888   8 8 88888   8  8
8   8   8   8   88888   8   8   8   8   8 8 8   8   8   8   8   8   8 8 8   8   88
8 888 8   8   8   8   8   8   8   8   8   8   8   8   8   8   8   8   8   8   8  8
8  88   8   8   8   8   8 8 8   88888   88888   8   8 8 8   8 888   8 8 8   8   88
8 8   8   8   8 888   8   8   8   8   8   8   8   8   8   8   8   8   8   8   8  8
8   8 8 8 888   8   8   8   8 888   8   8   8 8 8   8   8   8   8 8 8   8   8   88
8 8   8 8 8   8   8   8   8   88  8   8   8   8   8   8   88888   8   8   8   8  8
8   8   8 888   8   8 8 8   8   8   8 8 8   8 888   8   8   8   8   8 888   8   88
8 8   8   8   8 8 8   8   8   8   8   8   8   8   88888   8   8 8 8   8   8   8  8
8   8   8   8   8   88888   8   8   8 8 8   8   8   8   8   8 8 8   8   8   8 8888
888 888   8   8 8 8   8   8   8   8   8   8 8 8   8   8 8 8   8 888   8   8   8  8
88  8   8   8   8   8   8   8   8   8   8   8   8   8   8   8   8   8 888   8   88
888   8   8 88888 8   8   8   8   88888   88888   8 8 8   8   8   8   8   8   8  8
8   8       8   8   8   8   8   8   8   8   8   8   8   8   8   8   8   8   8   88
8 8   8 8 8   8   8   8   8   8   8   8   8   8   8   8   88888   8   8   8   8  8
8   8       8   8   8   88888   8   8   8   8   8   8 888 8 8   8   8   8   888888
8 8 888  88   8   8   8   8   8   8   8   8   8 888 8 8   8   8   8   8   8   8  8
8   8   88  8   8   8   8   8   8   88  8   8   8   8 888   8   8   8 8 8   8   88
8 8   8     88   8   888 8   8   8 8 8  888   8   8   8   8   8 8 8   8 8 8   8  8
8   8   88  8   8   8   8   8   8       8   8   8   8   8 888   8   8       8   88
8 8   8 888   8   8   8   8   8   8 8 8   8   8   8   8   8   8   8   888 8   8  8
888888888888888888888888888888888888888888888888888888888888 888888888888888888888