8888888888888888888888888888888888888888888888888888888888888888888888888888888888
8                                                                                8
8                   8                            8                   8           8
8       8                     8         8                      8            8    8
8                                                         8                      8
8    8        8                       8                             8            8
8                  8      8                  8                            8      8
8 8                             8                     8           8              8
8      8                                                                         8
8             *         8                 8                 8               8    8
8                                   8            8                    8          8
8           8     *                                        8          *          8
8    8                       8        ~~~~~~~                              8     8
8                     8              ~~~~~~~~~       8         8                 8
8             8                      ~~~~~~~~~                          *   8    8
8                                    ~~~~&~~~~                       8           8
8      8                             ~~~~~~~~~           8      8                8
8                       *     8      ~~~~~~~~~                                   8
8          *      8                   ~~~~~~~                        *      8    8
8    8                                                            8              8
8                        8                        *       8              8       8
8           8                                                                    8
8                            8          8                     8 *     8          8
8               *                              *     8                      8    8
8    8        8       8           8                               8              8
8                          *                               8                     8
8                                    *      8                             8      8
8            8          8                                                        8
8                  *           8                  8        8   *  8    8         8
8    8       *                         8       *                                 8
8                                                       8                        8
8        8          8       8              8                     8         8     8
8                                 8    8          8         *                    8
8              *                                                                 8
8888888888888888888888888888888888888888888888888888888888888888888888888888888888