++++++++111111111++++222222222++++333333333++++444444444++++555555555+++++++++++++
+       (Level 1)    (Level 2)    (Level 3)    (Level 4)    (Level 5)            +    
+                                                                                +
+                                                                                +
+                                                                                +
+                                                                                +
+                                                                                +
+                                                                                +
+                                                                                +
+                                                                                +
+                                                                                +
+                                                                                +
+                                                                                +
+                                                                                +
+                                                                                +
+                                                                                +
+                                                                                +
+                                                                                +
+                                                                                +
+                                                                                +
+                                                                                +
+                                                                                +
+                                                                                +
+                                                                                +
+                                                                                +
+                                                                                +
+                                                                                +
+                                                                                +
+                                                                                +
+                                                                                +
+                                                                                +
+                                                                                +
+                                                                                +
+       (Level 6)    (Level 7)    (Level 8)    (Level 9)    (Level 10)           +
++++++++666666666++++777777777++++888888888++++999999999++++0000000000++++++++++++