                                                                                  
                ____      _     _   _  ____   _____                               
               |  _ \    / \   | | | |/ ___| | ____|                              
               | |_) |  / _ \  | | | |\___ \ |  _|                                
               |  __/  / ___ \ | |_| | ___) || |___                               
               |_|    /_/   \_\ \___/ |____/ |_____|                              
                                                                                  
                                                                                  
8888888888888888888888888888888888888888888888888888888888888888888888888888888888
8                                                                                8
8                                                                                8
8                                                                                8
8                   <1> RESUME                                                   8
8                                                                                8
8                   <2> RETRY                                                    8
8                                                                                8
8                   <3> MENU                                                     8
8                                                                                8
8                   <4> QUIT                                                     8
8                                                                                8
8                                                                                8
8                                                                                8
8                                                                                8
8                                                                                8
8                                                                                8
8                                                                                8
8                                                                                8
8                                                                                8
8                                                                                8
8                                                                                8
8                                                                                8
8                                                                                8
8                                                                                8
8                                                                                8
8                                                                                8
8888888888888888888888888888888888888888888888888888888888888888888888888888888888