8888888888888888888888888888888888888888888888888888888888888888888888888888888888
8@777777777777777777777777777777777777777777777777777777777777777777777777777777@8
8777777777777777777777777777777777777777777777777777777777777777777777777777777778
8777777777777777777777777777777777777777777777777777777777777777777777777777777778
8777777777777777777777777777777777777777777777777777777777777777777777777777777778
8777777777777777777777777777777777777777777777777777777777777777777777777777777778
8777777777777777777777777777888888888888888888888887777777777777777777777777777778
8777777777777777777777777777777777777777777777777777777777777777777777777777777778
8777777777777777777777777777777777777777777777777777777777777777777777777777777778
8777777777777777777777777777777777777777777777777777777777777777777777777777777778
8777777777777777777777777777777777777777777777777777777777777777777777777777777778
8777777777777777777777777777777777777777777777777777777777777777777777777777777778
8777777777777777777777777777777777777777777777777777777777777777777777777777777778
8777777777777777777777777777777777777777777777777777777777777777777777777777777778
8777777777777777777777777777777777777777777777777777777777777777777777777777777778
8777777777777777777777777777777777777777777777777777777777777777777777777777777778
8777777777777777777777777777777777777777777777777777777777777777777777777777777778
8777777777777777777777777777777777777777777777777777777777777777777777777777777778
8777777788888888888888887777777777777777777777777888888888888888888888887777777778
8777777777777777777777777777777777777777777777777777777777777777777777777777777778
8777777777777777777777777777777777777777777777777777777777777777777777777777777778
8777777777777777777777777777777777777777777777777777777777777777777777777777777778
8777777777777777777777777777777777777777777777777777777777777777777777777777777778
8777777777777777777777777777777777777777777777777777777777777777777777777777777778
8777777777777777777777777777777777777777777777777777777777777777777777777777777778
8777777777777777777777777777777777777777777777777777777777777777777777777777777778
8777777777777777777777777777777777777777777777777777777777777777777777777777777778
8777777777777777777777777777777777777777777777777777777777777777777777777777777778
8777777777777777777777777777777777777777777777777777777777777777777777777777777778
8777777777777777777777777777777777777777777777777777777777777777777777777777777778
8777777777777777777777777788888888888888888888888888888777777777777777777777777778
8777777777777777777777777777777777777777777777777777777777777777777777777777777778
8777777777777777777777777777777777777777777777777777777777777777777777777777777778
8@777777777777777777777777777777777777777777777777777777777777777777777777777777@8
8888888888888888888888888888888888888888888888888888888888888888888888888888888888