8888888888888888888888888888888888888888888888888888888888888888888888888888888888
8@77777777777777777777777O777777777787777787777777777777777777777777777777777777@8
8777777777777777777777777777777777778777778777777777777777777777777777777777777778
8777777777777777777787777777777777778777778777777777778777777777777777777777777778
8777777777777777777777777777777777778777778777777777778777777777777777888877777778
8777777777777777777777777777777787777777777777777777778777777777777777777777777778
87777787777777777777777777777777877777777777777777777777777777777O7777777777777778
8777778777777777777777777777777777777777777777777777777777777777777777777777777778
8777777777777777777777777777777777777777777777777777777777778777777777777877777778
8777777777777777O77777777777777777777777777777777777777777777777777777777877777778
8777777777777777788887777777777777778777778777777777777777777777777777777777777778
87777777777777777777777777777777777O8777778777777777777777777777777777777777777778
8888888777777777777777777777788888888777778888888887777777777777777777777888888888
8O77777777777777777777777777777777777777777777777777777777777777777777777777777778
8777777777777777777777787777777777777777777777777777777778888877777777777777777778
877777777777777777777778777777777777777777777777777777777777O8777777777777777777O8
8777777777777777777777787777777777777777777777777777777777777877777777777777777778
87777777777777777777777777777777777O7777777777777777777777777777777777777777777778
8888888777777777777777777777788888888777778888888887777777777777777777777888888888
8777777777777777788887777777777777778777778777777777777777777777777777777777777778
8777777777777777777777777777777777778777778777777778877777777777777788888777777778
8777777777777777777777777777777777778777778777777O777777777787777777777O7777777778
8777777O77777777777777777777777777778777778777777777777777778777777777777777777778
8777777777777777777777778887777777777777777777777777777777778777777777777777777778
8777777777777777777777777777777777777777777777777777777777778777777777777777777778
8777777778888888877777777777777777777778777777777777777777777777777777777777777778
8777777777777777777777777788888777777778777777777777777777777777777788887777777778
8777777777777777777777777777778777777777777777777777777777777777777777787777777778
8777777777777777777787777777778777778777778O77777777778777777777777777787777777778
8777777777787777777777777777778777778777778777777777778777777777777777777777777778
8777777777787777777777777777777777778777778777777777777777777777777777777777777778
8777777777787777777777777777777777778777778777777777777777777777777777777777777778
8777777777777777777787777777777777778777778777777777778777777777777777777777777778
8@77777777777777777777777O777777777787777787777777777787777777777O77777777777777@8
8888888888888888888888888888888888888888888888888888888888888888888888888888888888